########################
#......................#
#..........####........#
#......................#
#....####..............#
#......................#
########################