########################
#......................#
#......................#
#.............E........#
#..........###.........#
#......###.............#
#.................P....#
########################
