########
#......#
#..E...#
#......#
#..P...#
########