############################
#..............B..........##
#...........#####.........##
#..........................#
#......B...................#
###.........######.....#####
#.....#...............#....#
#..........H...............#
############################